0  0  0  0  0  0  0  0  0  0  0  0  0  0  0  0  0  0  0  0  0
0  1  1  1  1  1  1  1  1  1  0  1  1  1  1  1  1  1  1  1  0
0  1  0  0  0  1  0  0  0  1  0  1  0  0  0  1  0  0  0  1  0
0  2  0  0  0  1  0  0  0  1  0  1  0  0  0  1  0  0  0  2  0
0  1  0  0  0  1  0  0  0  1  0  1  0  0  0  1  0  0  0  1  0
0  1  1  1  1  1  1  1  1  1  1  1  1  1  1  1  1  1  1  1  0
0  1  0  0  0  1  0  1  0  0  0  0  0  1  0  1  0  0  0  1  0
0  1  0  0  0  1  0  1  0  0  0  0  0  1  0  1  0  0  0  1  0
0  1  1  1  1  1  0  1  1  1  0  1  1  1  0  1  1  1  1  1  0
0  0  0  0  0  1  0  0  0  3  0  3  0  0  0  1  0  0  0  0  0
0  0  0  0  0  1  0  3  7  7  7  7  7  3  0  1  0  0  0  0  0
0  0  0  0  0  1  0  3  0  0  6  0  0  3  0  1  0  0  0  0  0
0  0  0  0  0  1  0  3  0  3  3  3  0  3  0  1  0  0  0  0  0
4  5  5  5  5  1  3  3  0  3  3  3  0  3  3  1  5  5  5  5  4
0  0  0  0  0  1  0  3  0  0  0  0  0  3  0  1  0  0  0  0  0
0  0  0  0  0  1  0  3  3  3  3  3  3  3  0  1  0  0  0  0  0
0  0  0  0  0  1  0  3  0  0  0  0  0  3  0  1  0  0  0  0  0
0  0  0  0  0  1  0  3  0  0  0  0  0  3  0  1  0  0  0  0  0
0  1  1  1  1  1  1  1  1  1  0  1  1  1  1  1  1  1  1  1  0
0  1  0  0  0  1  0  0  0  1  0  1  0  0  0  1  0  0  0  1  0
0  2  1  1  0  1  1  1  8  8  8  8  8  1  1  1  0  1  1  2  0
0  0  0  1  0  1  0  1  0  0  0  0  0  1  0  1  0  1  0  0  0
0  0  0  1  0  1  0  1  0  0  0  0  0  1  0  1  0  1  0  0  0
0  1  1  1  1  1  0  1  1  1  0  1  1  1  0  1  1  1  1  1  0
0  1  0  0  0  0  0  0  0  1  0  1  0  0  0  0  0  0  0  1  0
0  1  1  1  1  1  1  1  1  1  1  1  1  1  1  1  1  1  1  1  0
0  0  0  0  0  0  0  0  0  0  0  0  0  0  0  0  0  0  0  0  0